111111
1PE111
100001
1C1111
111111