1111111111111111111111111111111111
10000E000000000C00000C000000000001
100000010010000010100100000E010101
1000000010101010001001000000010101
1P0000000C00C000000000000W000000C1
1111111111111111111111111111111111