11111111111111111
100E00000000P0001
11111111111111111
