

111111111111111111111111
10010000000C0010000000C1
10010000000C0010000000C1
100011C0C0000000W00000C1
10010000000C0010000000C1
1W00011111000010000000C1
10001110C0000010000000C1
1111111111110010001000C1
10010000000C0000010000C1
1W00011111000010010000C1
1P001100C0000010000W00C1
10010000000C0010001000C1
1W00011111000010000000C1
10011E0C0000010000000C01
111111111111111111111111